-------------------------------------------
Source : www.bahai-biblio.org
-------------------------------------------

DIEU PASSE PRES DE NOUS

Shoghi Effendi


SOMMAIRE

Préface 
Introduction 

PREMIÈRE PÉRIODE: Ministère du Báb, 1844-1853 

CHAPITRE I: Naissance de la révélation bábi 

Déclaration de la mission du Báb - Engagement des Lettres du Vivant - Pèlerinage du Báb à La Mecque - Arrestation et départ du Báb pour Isfàhàn - Son séjour à lsfàhàn 

CHAPITRE II: Emprisonnement du Báb dans l'Adhirbàyjàn 

Signification de cette détention - Emprisonnement à Màh-Kù et à Chihriq - Son interrogatoire, à Tabriz - Ses écrits - Son covenant -Conférence de Badasht 

CHAPITRE III: Soulèvements de Mázindarán, Nayriz et Zanjàn 

Traits essentiels du soulèvement de Mázindarán - Principales caractéristiques du conflit de Nayriz - Incidents en rapport avec le conflit de Zanjàn - Les Septs-Martyrs de Tihrán 

CHAPITRE IV: Exécution du Báb 

Evénements qui précédèrent sa mort - Circonstances entourant son martyre - Hommages à sa mémoire - Parallèle entre sa mission et celle de Jésus-Christ - Signification de sa mission 

CHAPITRE V: Attentat à la vie du sháh et conséquences 

Circonstances de l'attaque contre Nàsiri'd-Din-Sháh - Massacre des bábis à Tihrán - Rôle de Bahá'u'lláh pendant le ministère du Bab - Son arrestation et son emprisonnement dans le Siyah-Chal - Arrestation et martyre de Tahirih - Exécution des principaux disciples du Bab - Hommages à l'héroïsme des babis - Sort des persécuteurs du Bab et de ses disciples 


SECONDE PÉRIODE: Ministère de Bahá'u'lláh, 1853-1892 

CHAPITRE VI: Naissance de la révélation Bahá'i 

Signification de la révélation de Bahá'u'lláh - Conditions qui présidèrent à sa naissance 

CHAPITRE VII: Exil de Bahá'u'lláh en 'Iráq 

Sa libération et son départ pour Baghdád - Signification de ce bannissement - Sa résidence à Baghdád, puis sa retraite au Kurdistàn 

CHAPITRE VIII: Exil de Bahá'u'lláh en 'Iráq (suite) 

Rehaussement du prestige de la communauté bábi - Réforme des moeurs de cette communauté - La reconnaissance du rang de Bahá'u'lláh s'accentue de plus en plus - Floraison de la littérature Bahá'i - Déconfiture des ennemis de la foi - Bahá'u'lláh quitte Baghdád 

CHAPITRE IX: Déclaration de la mission de Bahá'u'lláh - Son voyage à Constantinople 

Signification de cette déclaration - Son départ du jardin du Ridván - Incidents consécutifs à son voyage - Son séjour à Constantinople 

CHAPITRE X: Rébellion de Mirzá Yahyá - Proclamation de la mission de Baháu'llàh à Andrinople 

Mirzá Yahyá conteste la mission de Bahá'u'lláh - Proclamation du message de Bahá'u'lláh - Son bannissement à 'Akká 

CHAPITRE XI: Emprisonnement de Bahá'u'lláh à 'Akká 

Interprétation de son bannissement en Terre sainte - Sévices endurés pendant les premières années de sa détention - Relâchement progressif des restrictions imposées 

CHAPITRE XII: Emprisonnement de Bahá'u'lláh à 'Akká (suite) 

Nouvelle explosion de persécutions en Perse - Suites consécutives à sa proclamation à Andrinople - Révélation des lois et ordonnances de la dispensation Bahá'i - Formulation des principes fondamentaux qui soutiennent la révélation Bahá'i 

CHAPITRE XIII: Ascension de Bahá'u'lláh 

Détails relatifs à cette ascension - Sort de ceux qui furent ennemis de la foi, au temps de son ministère 


TROISIÈME PÉRIODE: Ministère d'Abdu'l-Bahá, 1892-1921 

CHAPITRE XIV: Le covenant de Bahá'u'lláh 

Sa signification - Traits dominants du livre de son covenant - Rôle assumé par 'Abdu'l-Bahá pendant le ministère de son père 

CHAPITRE XV: Rébellion de Mirzá Muhammad 'Ali 

Accusations lancées par les briseurs de covenant contre 'Abdu'l-Bahá - Comportement de Mirzá Muhammad 'Ali et de ses associés - Références faites par Bahá'u'lláh et 'Abdu'l-Bahá aux briseurs de covenant 

CHAPITRE XVI: Avènement et développement de la foi en Occident 

Références des écrits sacrés Bahá'i au sujet de l'Occident et de son importance future - Arrivée des premiers pèlerins occidentaux à 'Akká - Premiers développements de la foi en Amérique du Nord 

CHAPITRE XVII: Nouvel emprisonnement d'Abdu'l-Bahá 

Complots des briseurs de covenant - Nomination d'une commission d'enquête par le sultàn 'Abdu'l-Hamid - Activités d'Abdu'l-Bahá pendant sa détention - Enquête et départ de la commission - Révolution jeune-turque et libération d'Abdu'l-Bahá 

CHAPITRE XVIII: Ensevelissement des restes du Báb sur le mont Carmel 

Comment ils furent cachés et finalement transférés en Terre sainte - Leur inhumation par 'Abdu'l-Bahá 

CHAPITRE XIX: Voyages d'Abdu'l-Bahá en Europe et en Amérique 

Ses visites en Egypte - Ses voyages en Europe - Son séjour aux Etats-Unis d'Amérique - Brillants aperçus sur ces voyages 

CHAPITRE XX: Développement et expansion de la foi en Orient et en Occident 

Renouvellement des persécutions en Perse - Construction du premier Mashriqu'l-Adhkár à 'Ishqàbàd - Fermes progrès de la foi en Orient, en Europe et en Amérique du Nord - Guerre de 1914-1918; ses conséquences au centre mondial (Terre sainte) - Redoublement d'activité des Bahá'is et ouverture du continent australien à la foi 

CHAPITRE XXI: Derniers moments d'Abdu'l-Bahá 

Faits ultimes avant son décès - Ses funérailles - Signification de son ministère - Sort de ceux qui furent des ennemis de la foi, au temps de son ministère 


QUATRIÈME PÉRIODE: Début de l'âge de formation de la foi, 1921-1944 

CHAPITRE XXII: Avènement et instauration de l'ordre administratif 

Son origine - Caractère de la période de formation - Nature de l'ordre administratif - Attaques contre lui - Caractéristiques du testament d'Abdu'l-Bahá - Commencements de l'ordre administratif - Assemblées locales - Assemblées nationales - Comités nationaux - Constitutions Bahá'i - Déclaration légale des assemblées - Dotations Bahá'i - Institution du Haziratu'l-Quds - Ecoles d'été - Activités de la jeunesse et autres - Etablissement de contacts avec des organisations humanitaires et des autorités gouvernementales - Consolidation des institutions Bahá'i en Terre sainte - Edification du Mashriqu'l-Adhkár à Wilmette (III. U.S.A.) 

CHAPITRE XXIII: Attaques des institutions Bahá'i 

Les briseurs de covenant se saisissent des clés du tombeau de Bahá'u'lláh - Les shi'ahs s'emparent de la maison de Bahá'u'lláh à Baghdád - Persécution de la foi et disparition de ses institutions en Russie - Mesures de répression contre les institutions Bahá'i en Allemagne - Restrictions imposées aux institutions Bahá'i en Perse 

CHAPITRE XXIV: Emancipation et reconnaissance de la foi et des institutions 

Séparation officielle de la foi Bahá'i et de l'islám en Egypte - Reconnaissance de statuts indépendants pour la foi au centre mondial - Revendication de l'indépendance pour leur foi, de la part des fidèles de Perse - Reconnaissance officielle des institutions Bahá'i aux Etats-Unis d'Amérique 

CHAPITRE XXV: Développement international de l'enseignement 

Agrandissement du champ d'action de la foi - Diffusion de sa littérature - Activités de Martha Root pour l'enseignement mondial - Conversion de la reine de Roumanie - La communauté Bahá'i américaine mène à bien un plan de Sept Ans 

CHAPITRE XXVI: Examen rétrospectif et perspectives d'avenir 


